C _ _ _ B _
_ B _ _ _ _
_ _ F _ _ _
_ _ _ B B _
_ _ _ A _ _
_ _ _ _ _ S