C _ B _ _ _
_ _ B _ F _
_ B _ _ B _
_ _ _ B _ _
_ _ A _ B _
_ _ _ _ _ S